        r'Abs|ACos|Asc|'
        r'ASin|ATan|Ceil|'
        r'Chr|Cos|DllCall|'
        r'Exp|FileExist|Floor|'
        r'GetKeyState|IL_Add|IL_Create|'
        r'IL_Destroy|InStr|IsFunc|'
        r'IsLabel|Ln|Log|'
        r'LV_Add|LV_Delete|LV_DeleteCol|'
        r'LV_GetCount|LV_GetNext|LV_GetText|'
        r'LV_Insert|LV_InsertCol|LV_Modify|'
        r'LV_ModifyCol|LV_SetImageList|Mod|'
        r'NumGet|NumPut|OnMessage|'
        r'RegExMatch|RegExReplace|RegisterCallback|'
        r'Round|SB_SetIcon|SB_SetParts|'
        r'SB_SetText|Sin|Sqrt|'
        r'StrLen|SubStr|Tan|'
        r'TV_Add|TV_Delete|TV_GetChild|'
        r'TV_GetCount|TV_GetNext|TV_Get|'
        r'TV_GetParent|TV_GetPrev|TV_GetSelection|'
        r'TV_GetText|TV_Modify|VarSetCapacity|'
        r'WinActive|WinExist|Object|'
        r'ComObjActive|ComObjArray|ComObjEnwrap|'
        r'ComObjUnwrap|ComObjParameter|ComObjType|'
        r'ComObjConnect|ComObjCreate|ComObjGet|'
        r'ComObjError|ComObjValue|Insert|'
        r'MinIndex|MaxIndex|Remove|'
        r'SetCapacity|GetCapacity|GetAddress|'
        r'_NewEnum|FileOpen|Read|'
        r'Write|ReadLine|WriteLine|'
        r'ReadNumType|WriteNumType|RawRead|'
        r'RawWrite|Seek|Tell|'
        r'Close|Next|IsObject|'
        r'StrPut|StrGet|Trim|'
        r'LTrim|RTrim
